....................................................................
....................................................................
....................X...............................................
..............XXX...D.........................F.....................
..........X...DDD...D.......X................XXX....................
...P..T..XDSSSDDDSSSD.......X..............SSDDD....................
XXXXXXXXXDDXXXDDXXXXDXXX...XXXXX...XXXXXXXXXXDDDXXXXXXXXXXX.........
DDDDDDDDDDDDDDDDDDDDDDDDSSSDDDDDSSSDDDDDDDDDDDDDDDDDDDDDDDD.........
DDDDDDDDDDDDDDDDDDDDDDDDDDDDDDDDDDDDDDDDDDDDDDDDDDDDDDDDDDD.........
DDDDDDDDDDDDDDDDDDDDDDDDDDDDDDDDDDDDDDDDDDDDDDDDDDDDDDDDDDD.........
..................................................R.................
....................................................................
....................................................................
XXXXXXXXXXXXXXXXXXXXXXXXXXXXXXXXXXXXXXXXXXXXXXXXXXXXXXXXXXXXXXXXXXXX
DDDDDDDDDDDDDDDDDDDDDDDDDDDDDDDDDDDDDDDDDDDDDDDDDDDDDDDDDDDDDDDDDDDD
DDDDDDDDDDDDDDDDDDDDDDDDDDDDDDDDDDDDDDDDDDDDDDDDDDDDDDDDDDDDDDDDDDDD