....................................................................
....................................................................
....................X...............................................
..............XXX...D.........................F.....................
..P.......X...DDD...D.......X................XXX....................
.........XDSSSDDDSSSD.......D..............SSDDD....................
XXXXXXXXXDDXXXDDXXXXDXXX...XDXXX...XXXXXXXXXXDDDXXXXXXXXXXX.........
DDDDDDDDDDDDDDDDDDDDDDDDSSSDDDDDSSSDDDDDDDDDDDDDDDDDDDDDDDD.........
DDDDDDDDDDDDDDDDDDDDDDDDDDDDDDDDDDDDDDDDDDDDDDDDDDDDDDDDDDD.........
DDDDDDDDDDDDDDDDDDDDDDDDDDDDDDDDDDDDDDDDDDDDDDDDDDDDDDDDDDD.........
........................s..s..s....R....R....R....R.................
....................................................................
........................T..T..T.....................................
XXXXXXXXXXXXXXXXXXXXXXXXXXXXXXXXXXXXXXXXXXXXXXXXXXXXXXXXXXXXXXXXXXXX
DDDDDDDDDDDDDDDDDDDDDDDDDDDDDDDDDDDDDDDDDDDDDDDDDDDDDDDDDDDDDDDDDDDD
DDDDDDDDDDDDDDDDDDDDDDDDDDDDDDDDDDDDDDDDDDDDDDDDDDDDDDDDDDDDDDDDDDDD